1 10 8
##########
#.      .#
# 0    0 #
#   1   c#
#        #
# 0    0 #
#.      .#
##########
2 5 5
#####
#1  #
# 0 #
#  .#
#####
