1 10 8
##########
#.      .#
# O    O #
#   1   C#
#        #
# O    O #
#.      .#
##########
2 5 5
#####
#1  #
# O #
#  .#
#####
3 9 8
#########
#   1   #
#  ###  #
# O#.   #
#  ###  #
#       #
#       #
#########
4 8 8
        
   1    
 # O  # 
        
   .    
        
        
        
